@@@@@@@@@@@@@@@@@@@@@@@@@@@@
@............@@............@
@*@@@@.@@@@@.@@.@@@@@.@@@@*@
@.@@@@.@@@@@.@@.@@@@@.@@@@.@
@..........................@
@.@@@@.@@.@@@@@@@@.@@.@@@@.@
@......@@....@@....@@......@
@@@@@@.@@@@@ @@ @@@@@.@@@@@@
@    @.@@          @@.@    @
@    @.@@ @@@^^@@@ @@.@    @
@@@@@@.@@ @      @ @@.@@@@@@
<     .   @      @   .     >
@@@@@@.@@ @      @ @@.@@@@@@
@    @.@@ @@@@@@@@ @@.@    @
@    @.@@          @@.@    @
@@@@@@.@@ @@@@@@@@ @@.@@@@@@
@............@@............@
@.@@@@.@@@@@.@@.@@@@@.@@@@.@
@*..@@................@@..*@
@@@.@@.@@.@@@@@@@@.@@.@@.@@@
@......@@....@@....@@......@
@.@@@@@@@@@@.@@.@@@@@@@@@@.@
@..........................@
@@@@@@@@@@@@@@@@@@@@@@@@@@@@
