####################
#------------------#
#----bbb-----------#
#-----b--------b---#
#-----b--------b---#
#----------bbbbb---#
#------------------#
####################
